16 16 16 16 16 16 16 16 16 16 16 16 16 16 16 16 16 16 16 16 16 16 16 16 16 16 16 16 16 16 16 16 16 16 16 16 16 16 16 16 16 16 16 16 16 16 16 16 16 16 
16 1 1 1 33 33 1 1 1 33 1 1 1 33 33 2 1 1 1 1 1 1 2 33 33 33 1 1 1 2 2 2 2 2 2 2 2 2 2 2 2 2 2 2 2 2 2 33 33 16 
16 1 1 1 2 2 1 1 1 2 1 1 1 2 2 2 2 2 2 2 2 2 2 2 2 2 2 2 2 2 2 2 2 2 2 2 2 2 2 2 2 2 2 2 2 2 2 33 33 16 
16 20 21 22 1 1 16 12 10 10 10 13 16 16 16 16 16 16 16 2 2 2 2 2 16 16 16 16 16 16 16 16 16 16 16 16 16 16 16 16 16 16 16 16 16 16 16 16 16 16 
16 23 19 24 1 1 1 8 3 3 3 7 1 1 1 2 2 2 2 2 2 2 2 2 16 16 16 16 16 16 16 16 16 16 16 16 16 16 16 16 16 16 16 16 16 16 16 16 16 16 
16 23 19 24 1 1 1 8 3 3 3 7 1 1 1 2 2 2 2 2 2 2 2 2 16 16 2 2 2 2 2 2 2 2 2 2 2 2 2 2 2 2 2 2 2 2 2 2 2 16 
16 23 19 30 21 22 1 8 3 3 3 7 1 1 1 2 2 2 2 2 2 33 2 2 16 16 2 2 2 20 21 21 21 21 22 2 2 2 2 2 2 2 2 2 2 2 2 2 2 16 
16 25 26 26 26 27 16 8 3 3 3 7 16 16 16 16 16 16 16 2 2 33 2 2 16 16 2 2 20 31 18 18 18 18 24 2 2 2 2 2 2 2 2 2 2 2 2 2 2 16 
16 16 2 2 2 16 2 8 3 3 3 7 16 16 33 33 33 16 16 2 2 2 2 2 16 16 2 2 23 18 18 18 18 18 24 2 2 2 2 2 2 2 2 2 2 2 2 2 2 16 
16 16 16 16 16 16 16 8 3 3 3 7 16 16 2 2 2 16 16 2 2 2 2 2 16 16 2 2 23 18 18 18 28 26 27 2 2 2 2 2 2 2 2 2 2 2 2 2 2 16 
32 32 32 32 32 16 16 8 3 3 3 7 16 16 2 2 2 16 16 2 2 2 2 2 16 16 2 2 25 29 18 18 30 22 2 16 16 16 16 16 16 16 16 16 16 16 16 16 16 16 
32 32 32 32 32 16 16 8 3 3 3 7 16 16 2 2 2 16 16 2 2 2 2 2 16 16 2 2 2 25 26 26 26 27 2 32 32 32 32 32 32 32 32 32 32 32 32 32 32 32 
32 17 17 17 32 16 16 8 3 3 3 7 16 16 2 2 2 16 16 2 2 2 2 2 16 16 2 2 2 2 2 2 2 2 2 32 34 34 34 34 34 34 34 34 34 34 34 34 34 32 
32 17 17 17 32 16 16 8 3 3 3 7 33 16 2 2 2 16 16 2 2 2 2 2 16 16 2 2 2 2 2 2 2 2 2 32 34 34 34 34 34 34 34 34 34 34 34 34 34 32 
32 17 17 17 32 16 16 8 3 3 3 7 33 16 2 2 2 2 2 2 2 2 2 2 2 2 2 2 2 2 2 2 2 2 2 32 34 34 34 34 34 34 34 34 34 34 34 34 34 32 
32 17 17 17 32 16 16 8 3 3 3 7 16 16 2 2 2 2 2 2 2 2 2 2 2 2 2 2 2 2 2 2 2 2 2 32 32 32 32 32 32 34 34 34 34 34 34 34 34 32 
32 17 17 17 32 16 33 8 3 3 3 7 16 16 16 16 16 16 16 16 16 16 16 16 16 16 16 16 16 16 16 16 16 16 16 16 16 16 16 16 32 34 34 34 34 34 34 34 34 32 
32 17 17 17 32 16 33 8 3 3 3 7 16 16 16 16 16 16 33 33 16 16 16 16 16 16 16 33 33 16 16 16 16 16 16 16 16 16 16 16 32 34 34 34 34 34 34 34 34 32 
32 17 17 17 32 16 16 8 3 3 3 9 10 10 10 10 10 10 10 10 10 10 10 10 10 10 10 10 10 10 10 10 10 10 10 10 10 10 10 10 13 34 34 34 34 34 34 34 34 32 
32 17 17 17 32 16 16 8 3 3 3 3 3 3 3 3 3 3 3 3 3 3 3 3 3 3 3 3 3 3 3 3 3 3 3 3 3 3 3 3 7 34 34 34 34 34 34 34 34 35 
32 17 17 17 32 16 16 8 3 3 3 3 3 3 3 3 3 3 3 3 3 3 3 3 3 3 3 3 3 3 3 3 3 3 3 3 3 3 3 3 7 34 34 34 34 34 34 34 34 35 
32 17 17 17 32 16 16 8 3 3 3 3 3 3 3 3 3 3 3 3 3 3 3 3 3 3 3 3 3 3 3 3 3 3 3 3 3 3 3 3 7 34 34 34 34 34 34 34 34 35 
32 17 17 17 32 16 16 14 5 5 5 5 5 5 5 5 5 5 5 6 3 3 3 4 5 5 5 5 5 5 5 5 5 5 5 5 5 5 5 5 15 34 34 34 34 34 34 34 34 32 
32 17 17 17 32 16 16 16 33 33 16 16 16 16 16 16 16 16 16 8 3 3 3 7 16 16 16 16 16 16 16 16 16 16 16 16 16 16 16 32 33 34 34 34 34 34 34 34 34 32 
32 17 17 17 32 16 16 16 16 16 16 16 16 16 16 16 16 16 16 8 3 3 3 7 16 16 16 16 16 16 16 16 16 16 16 16 16 16 16 32 33 34 34 34 34 34 34 34 34 32 
32 17 17 17 32 32 32 32 32 32 32 32 32 32 32 32 32 32 32 8 3 3 3 7 16 16 16 16 16 16 16 16 16 16 16 16 16 16 16 32 32 32 32 32 34 34 34 32 32 32 
32 17 17 17 17 17 17 17 17 37 12 10 10 10 10 10 10 10 10 11 3 3 3 7 16 16 16 16 16 16 16 16 16 16 16 16 16 16 16 32 32 32 32 32 34 34 34 32 32 32 
32 17 17 17 17 17 17 17 17 37 8 3 3 3 3 3 3 3 3 3 3 3 3 7 16 16 16 16 16 16 16 16 16 16 16 16 16 16 16 32 32 32 32 32 34 34 34 32 32 32 
32 17 17 17 17 17 17 17 17 37 8 3 3 3 3 3 3 3 3 3 3 3 3 7 16 16 16 16 16 16 16 16 16 16 16 16 16 16 16 32 32 32 32 32 34 34 34 32 32 32 
32 17 17 17 17 17 17 17 17 37 8 3 3 3 3 3 3 3 3 3 3 3 3 7 16 16 16 16 16 16 16 16 16 16 16 16 16 16 16 32 32 32 32 32 34 34 34 32 32 32 
32 17 17 17 17 17 17 17 17 37 14 5 5 5 5 5 5 5 5 6 3 3 3 7 16 16 16 16 16 16 16 16 16 16 16 16 16 16 16 32 32 32 32 32 34 34 34 32 32 32 
32 32 32 32 32 32 32 32 32 32 32 32 32 32 32 32 32 32 32 8 3 3 3 7 16 16 16 16 16 16 16 16 16 16 16 16 16 16 16 32 32 32 32 32 34 34 34 32 32 32 
32 32 32 32 32 32 32 32 32 32 32 32 32 32 32 32 32 32 32 8 3 3 3 7 16 16 16 16 16 16 16 16 16 16 16 16 16 16 16 32 32 32 32 32 34 34 34 32 32 32 
16 16 16 16 16 16 16 16 16 16 16 16 16 16 16 16 16 16 16 8 3 3 3 7 16 16 16 16 16 16 16 16 16 16 16 16 16 16 16 32 32 32 32 32 34 34 34 32 32 32 
16 20 21 21 21 21 21 21 21 22 16 16 16 16 16 16 16 16 16 8 3 3 3 7 16 16 16 16 16 16 16 16 16 16 16 16 16 16 16 32 32 32 32 32 34 34 34 32 32 32 
16 23 19 19 19 19 19 19 19 24 16 16 16 16 16 16 16 16 16 8 3 3 3 7 16 16 16 16 16 16 16 16 16 16 16 16 16 16 16 32 32 32 32 32 34 34 34 32 32 32 
16 23 19 19 19 19 19 19 19 24 16 16 16 16 16 16 16 16 16 8 3 3 3 7 16 16 16 16 16 16 16 16 16 16 16 16 16 16 16 32 32 32 32 32 32 32 32 32 32 32 
16 23 19 19 19 19 19 19 19 24 16 16 16 16 16 16 16 16 16 8 3 3 3 7 16 16 16 16 16 16 16 16 16 16 16 16 16 16 16 16 16 16 16 16 16 16 16 16 16 16 
16 23 19 19 19 19 19 19 19 24 16 16 16 16 16 16 16 16 16 8 3 3 3 7 16 16 16 16 16 16 16 16 16 16 16 16 16 16 16 16 16 16 16 16 16 16 16 16 16 16 
16 23 19 19 19 19 19 19 19 24 12 10 10 10 10 10 10 10 10 11 3 3 3 7 16 16 16 16 16 16 16 16 16 16 12 10 10 10 10 10 10 10 10 10 10 10 10 10 13 16 
16 23 19 19 19 19 19 19 19 24 8 3 17 3 3 3 17 17 3 3 3 3 3 7 16 16 16 16 16 16 16 16 16 16 8 3 3 3 3 3 3 3 3 3 3 3 3 3 7 16 
16 23 19 19 19 19 19 19 19 24 8 17 17 17 17 17 17 17 3 3 3 3 3 7 16 16 16 16 16 16 16 16 16 16 8 3 3 3 3 3 3 3 3 3 3 3 3 3 7 16 
16 23 19 19 19 19 19 19 19 24 8 3 17 3 3 3 17 17 3 3 3 3 3 7 16 16 16 16 16 16 16 16 16 16 14 5 5 5 5 5 5 5 5 5 6 3 3 3 7 16 
16 23 19 19 19 19 19 19 19 24 14 5 5 5 5 5 5 5 5 6 3 3 3 7 16 16 16 16 16 16 16 16 16 16 16 16 16 16 16 16 16 16 16 16 8 3 3 3 7 16 
16 25 26 26 26 26 26 26 26 27 16 16 16 16 16 16 16 16 16 8 3 3 3 9 10 10 10 10 10 10 10 10 10 10 10 10 10 10 10 10 10 10 10 10 11 3 3 3 7 16 
16 16 16 16 16 16 16 16 16 16 16 16 16 16 16 16 16 16 16 8 3 3 3 3 3 3 3 3 3 3 3 3 3 3 3 3 3 3 3 3 3 3 3 3 3 3 3 3 7 16 
32 32 32 32 32 32 32 32 32 32 32 32 32 32 32 32 32 16 16 8 3 3 3 3 3 3 3 3 3 3 3 3 3 3 3 3 3 3 3 3 3 3 3 3 3 3 3 3 7 16 
32 32 32 32 32 32 32 32 32 32 32 32 32 32 32 32 32 16 16 8 3 3 3 3 3 3 3 3 3 3 3 3 3 3 3 3 3 3 3 3 3 3 3 3 3 3 3 3 7 16 
32 32 32 32 32 32 32 32 32 32 32 32 32 32 32 32 32 16 16 14 5 5 5 5 5 5 5 5 5 5 5 5 5 5 5 5 5 5 5 5 5 5 5 5 5 5 5 5 15 16 
32 32 32 32 32 32 32 32 32 32 32 32 32 32 32 32 32 16 16 16 16 16 16 16 16 16 16 16 16 16 16 16 16 16 16 16 16 16 16 16 16 16 16 16 16 16 16 16 16 16 
